###########################
# #P #                    #
#                         #
#                         #
#                         #
#                         #
#                       X #
###########################
